0 1 2 2 2 
1 0 2 1 5 
2 2 0 3 1 
2 1 3 0 0 
2 5 1 0 0 
